math.NA	numerical methods error convergence element
math.AG	projective curves varieties moduli smooth
math.FA	banach spaces operators infty bounded
math.NT	prime numbers modular forms conjecture
math.CV	holomorphic domains analytic unit domain
math.AP	solutions solution existence initial global
math.GM	fuzzy numbers new prime primes
math.OC	control optimization optimal algorithm convex
math.ST	estimator estimation estimators distribution regression
math.PR	random process processes stochastic distribution
math.DG	curvature manifold manifolds riemannian metric
math.CO	graphs vertices vertex edges conjecture
math.OA	von unital neumann crossed product
math.RT	representations representation irreducible category module
math.CA	polynomials inequalities operators integral new
math.DS	dynamical maps periodic invariant measure
math.GR	subgroup subgroups finitely free generated
math.QA	hopf sl vertex affine representations
math.LO	omega cardinal kappa forcing definable
math.RA	rings characteristic graded associative matrices
math.SG	symplectic lagrangian hamiltonian manifold contact
math.AT	homotopy cohomology category spaces homology
math.AC	ideal ideals rings local module
math.GT	knot knots link links homology
math.MG	metric convex spaces euclidean bodies
physics.optics	optical light photonic demonstrate laser
physics.flu-dyn	flow fluid velocity turbulent turbulence
physics.atom-ph	atoms atomic states laser atom
physics.ins-det	detector detectors resolution high performance
physics.acc-ph	beam accelerator electron bunch rf
physics.gen-ph	universe relativity mass gravitational physical
physics.plasm-ph	plasma plasmas electron magnetic ion
physics.chem-ph	molecular molecules calculations density electronic
physics.soc-ph	networks social nodes distribution agents
physics.class-ph	motion classical electromagnetic force shown
cs.CV	image images recognition object features
cs.GT	games game equilibrium players mechanism
cs.IT	channel codes rate capacity coding
cs.AI	reasoning knowledge decision belief inference
cs.DC	computing distributed cloud parallel applications
cs.CL	language word text words translation
cs.NI	networks wireless routing nodes traffic
cs.SE	software development process engineering requirements
cs.CC	complexity polynomial np prove lower
cs.CR	security attacks attack secure key
cs.LG	classification training methods machine propose
cs.LO	proof semantics calculus properties logics
cs.SY	control controller stability state controllers
cs.CY	students technology research social education
cs.DS	log approximation graphs given size
cs.PL	programming programs language program languages
cs.OH	process technology software use high
cs.DB	query database queries databases mining
